FBBBBBBBBBFBBBBBFB
D9515555535955535B
DA4A6AAACA5A2ACA1A
DA5A19535A5C575C52
DA58524A5A3AAABACA
DA5A4E5A585551535A
DA5A3ADA5A6ECA4A5A
DA5C575E5A7FDA5A5A
DA3AAAFEDA7FDA5A5A
D855537FDA7FDE5A5A
DA2ACA3BDA7FFA9A5A
DC535C535A7FD9565A
FA8A7A8A5A3BDA2A9A
DD5259565C535C5556
FA8A5A2ABACA7AAAEA
D9565C55535E59535B
DA2ABAAACA3A9A4A1A
DC5555575C55565C56

3, 3
4, 4
