FBBBBBBBBBBBFB
D955555155535B
DA6AAACA6A8A5A
DA59535A5D525A
DA1A4A5A7ECA5A
D8565E5A7FDA5A
DA6AFEDA7FDA1A
DA5B7FDA7FD856
DA5A3BDA7FDA2A
DA58535A7FD853
DA5A4A5A7B9A4A
DA5A5A5A5D565A
DA1A5A5A3AAA9A
DC565E5C555556

1, 1
11, 8
