B5D515553595555555
A3A8A6A8A5A6AAAAAC
8515659565A5955535
A4A6ADA6A9A5A6A8A1
A5A5B5A5D565A59545
A5A1A5A3AAA9A5A2AA
A5C565C51555658515
A7AAAFECA2AEEDA4A4
A59537FDC577FDA5A5
A5A4A3BFEEEFB9A5A5
A5A58577FFFDD565A5
A5A5A2AFBBBFAEA9A5
A5E5C5359575B59565
A3ABACA5A2A9A5A2AB
855535A5855565C555
A6ACA5A5A2AAAFAAAC
A5B5A5A5C555359575
A1A5A1A7AAA8A5A2A9

0, 0
4, 4
