FBBBBBBBBBFBBB
D9555555535953
DA2AAAAACA1A4A
D85555535C525E
DA2AEA8A7ECA3A
DC535D527FDC51
FA8A7ECA7FFA88
D9567FDA7FD956
DA6ABBDA7FDA6A
DA59575E7FDA5B
DA5A2ABABB9A5A
DA5C555555565A
DA3AAAAAAAAA9A
DC555555555556

1, 1
14, 5
