D555155555151555157
AAA8A6AAACA4A2ACA2A
D555659575A58575857
AEAEADA6ADA1A2ADA2A
F5B5B5A5B5854575857
A9A1A1A5A5A2AEADA6A
D5454565E58575F5A5B
AAAAAEABADA6AFADA1A
D555759575A5F5B5856
AAAAADA2ADA3ADA5A2A
D5557585758575A5857
AEAAA9A6ADA2ADA1A2A
F5955565B5857585457
ADA6AEADA5A6ADA6AEA

0, 0
14, 14
