FBFBBBBBBBBBBB
DB5D5155555553
DA7A8A6AAAAACA
DA59565955535A
DA1A6A9A6ECA1A
D8565D527FD856
DA2AFECA7FDA6A
DC537FDA7FDA5B
FA8A3BDA7FDA1A
D954535A7FDC56
DA6ACA5A3BFAAA
DA5B5A5C535953
DA1A5A3ACA1A4A
DC565C575C565E

1, 1
11, 8
