FBFBBBFBBBBBBB
DB595359555553
DA5A4A5A2AAACA
DA5A5A5C55535E
DA1A5A3AEECA3A
D8525C537FDC53
DA4A7ECA7FFA8A
DA5E7FDA7FD956
DA3ABBDA7FDA2A
DC55535A7FDC53
FAAA8A5A7BBA8A
D951565A595156
DA4A2ADA1A4A2A
DE5C575C565C57

1, 1
11, 8
