FBFBBBFBBBFBBB
DB595359535D53
DA1A4A5A4A3A8A
D8565A5A5C5156
DA2ADA1A7ECA2A
DC535C527FDC53
FACA7ECA7FFACA
DB5A7FDA7FDB5A
DA1A3BDA7FDA5A
DC54575A7FDA5A
FAEAAADA7B9A5A
DB59535A59525A
DA1A4A1A5A4A1A
DC565C565E5C56

1, 1
11, 8
