D535D51535B5955515
ACA3A8A4A5A1A6A8A4
B5855565A5C565D525
A5A2AEA9A7AAABACA5
A585359565D51535A5
A5A4A5A2ABA8A4A1A5
A5E5A5C5155565C565
A3ADA7ECA2AEEFAEA9
8535E7FDC577FDB595
A4A3ABBFEEEFB9A1A6
A5855537FFFDD5565
A5A6ACA3BBBFACA2AD
A5A5B5C51575B5C575
A5A5A7A8A6A9A7AAA9
A5A5A5956595659515
A5A1A5A2A9A6A9A4A2
A5C565C555659565C5
A3AAABAAAAA9A6ABA8

0, 0
4, 4
