D555551515551555153
AEAAA8A4A6A8A6ACA4A
F5955565A59565B5A5A
A9A6AAA9A5A2ADA1A1A
D565955565857585456
AEA9A6AEA9A6ADA2AAA
F59565B5D565F585557
ADA2A9A7AEAFADA2AAA
F5855565B5F5F585557
A9A2AEADA3ABADA6AEA
D54575B5855575A5B5B
AEAAA9A5A2AAADA5A5A
F5955565855575A5A5A
ADA6AEADA6AEADA5A5A

0, 0
14, 14
